%s ago=%s тому
%s is out of range minimum 1 maximum 65535=%s знаходиться поза діапазоном, мінімум 1 максимум 65535
12 hours=12 годин
24 hours=24 години
8023ad=802.3ad
Accumulation duration=Тривалість накопичення
Accumulation frequency=Частота накопичення
Activate=Активувати
Activated=Активовано
Activating=Активація
Active Directory Settings=Налаштування Active Directory
Active Directory=Active Directory
active-backup=активне резервне копіювання
AD account login=Вхід в обліковий запис AD
AD account password=Пароль облікового запису AD
AD domain name=Доменне ім'я AD
AD initial group=AD початкова група
AD initial owner=Початковий власник AD
AD join status=статус приєднання до AD
AD short domain name=AD коротке доменне ім'я
Add Peer=Додати Вузол
Add Route=Додати маршрут
Add Tunnel=Додати тунель
Add VLAN=Додати VLAN
Advanced=Розширений
Agent function=Функція агента
Agents=Агенти
Alerts=Сповіщення
Allow Remote Access=Дозволити віддалений доступ
Allow=Дозволити
and, the first and last characters must be alphanumeric=і перший і останній символи мають бути буквено-цифровими
and=i
APC UPS Daemon user manual=Посібник користувача APC UPS Daemon
APCsmart=APCsmart
Apply to activate Docker after Array is Started=Застосувати, щоб активувати Docker після запуску масиву
Apply to activate VMs after Array is Started=Застосувати для активації віртуальних машин після запуску масиву
Applying=Застосування
Array must be Stopped to change=Щоб змінити масив, необхідно **Зупинити**
Array status notification=Повідомлення про стан масиву
Array status=Стан масиву
Assignment error=Помилка завдання
Attention=Увага
Attribute=Атрибут
Authentication method=Метод аутентифікації
automatic=автоматичний
Autostart=Авто старт
Available notifications=Доступні сповіщення
Balance schedule=Графік балансу
balance-alb=баланс-alb
balance-rr=баланс-rr
balance-tlb=баланс-tlb
balance-xor=баланс-xor
Bar color - Text=Панель (колір) - Текст
Bar color=Панель (колір)
Bar gray - Text=Панель (сіра) - Текст
Bar gray=Панель (сіра)
Basic=Основний
Battery Charge=Заряд батареї
Battery level to initiate shutdown=Рівень батареї для початку вимкнення
bfq=bfq
Block group usage=Блокувати використання групи
Bonding members of=Об’єднання членів
Bonding mode=Режим склеювання
Both=Обидва
bottom-left=
bottom-right=
Bridging members of=Об’єднання членів
broadcast=транслювати
Browser=Браузер
btrfs filesystem show=Показ файлової системи btrfs
btrfs scrub status=Статус очищення btrfs
btrfs vDisk=btrfs vDisk
Cache disk not enabled=Cache-диск не ввімкнено
Cache Settings=Налаштування Кешу
Cannot provision cert that would overwrite your existing custom cert at=Неможливо надати сертифікат, який замінив би ваш існуючий спеціальний сертифікат за адресою
Cannot renew cert until within 30 days of expiry=Не можна поновити сертифікат протягом 30 днів після закінчення терміну дії
Cannot renew a custom cert at=Неможливо поновити спеціальний сертифікат на
CA-signed certificate file=Файл сертифіката, з підписом CA
Celsius=Цельсія
center=центр
Certificate expiration=Термін дії сертифіката
Certificate issuer=Емітент сертифіката
Certificate subject=Тема сертифіката
Certificate will not renew unless you are signed in to Unraidnet=Сертифікат не буде поновлено, якщо ви не ввійдете в систему Unraid.net
Changes=Зміни
Check cable=Перевірте кабель
Check four times a day=Перевірка чотири рази на день
Check once a day=Перевірка один раз на день
Check once a month=Перевірка раз на місяць
Check once a week=Перевірка раз на тиждень
Check twice a day=Перевірка двічі на день
Checking=Перевірка
CIDR optional=CIDR необов'язковий
Click here to see the Unraid Wiki for more information=Натисніть тут, щоб переглянути Unraid Wiki для отримання додаткової інформації
Click to invoke the Mover=Натисніть, щоб викликати Mover
Click to select PNG file=Натисніть, щоб вибрати файл PNG
Click to Select=Натисніть, щоб вибрати
Comma separated list of IPv4 and IPv6 IP addresses=Список IP-адрес IPv4 та IPv6, розділених комами
configure your router with a static route of=налаштуйте свій маршрутизатор за допомогою статичного маршруту
configure your router with port forwarding of port=налаштуйте маршрутизатор з переадресацією порту
configuring interface=налаштування інтерфейсу
Confirm array stop command=Підтверджувати команду зупинки масиву
Confirm reboot powerdown commands=Підтверджувати команди перезавантаження та вимкнення живлення
Confirm sleep command=Підтвердити команду сну
Confirmations=Підтвердження
connect to any device on the VPN tunnel=підключитися до будь-якого пристрою в тунелі VPN
connect to this server using IP address=підключитися до цього сервера за допомогою IP-адреси
Container=Контейнер
Content=Зміст
Correct file system errors=Виправте помилки файлової системи
CPU Isolation A reboot is required to apply changes=Ізоляція CPU: для застосування змін потрібне перезавантаження
CPU isolation is prohibited while system is running in SAFE MODE=Ізоляція CPU заборонена, коли система працює в БЕЗПЕЧНОМУ РЕЖИМІ
CPU Isolation=Ізоляція CPU
CPU Pinning Docker=Закріплення CPU в Docker
CPU Pinning VM=
CPU Pinning=Закріплення CPU
CRAM-MD5=CRAM-MD5
Cumulative parity check=Кумулятивна перевірка на парність
Current date and time=Поточна дата та час
Current usage ratio=Поточний коефіцієнт використання
Custom attributes use comma to separate numbers=Спеціальні атрибути (використовуйте кому для розділення чисел)
Custom banner=Спеціальний банер
Custom UPS cable=Спеціальний кабель UPS
Custom=Спеціальний
custom=спеціальний
D comma G dot=[D] кома : [G] крапка
D comma G none=[D] кома : [G] ніякий
D comma G space=[D] кома : [G] пробіл
D dot G comma=[D] крапка : [G] кома
D dot G none=[D] крапка : [G] ніякий
D dot G space=[D] крапка : [G] пробіл
Daily=Щодня
Data received=Дані отримані
Data sent=Дані надіслано
Date and Time=Дата і Час
Date format=Формат дати
Day of the month=День місяця
Day of the week=День тижня
Day, D Month YYYY=День, Д Місяць РРРР
Day, DD.MM.YYYY=День, ДД.ММ.РРРР
Day, DD-MM-YYYY=День, ДД-ММ-РРРР
Day, MMDDYYYY=День, ММ/ДД/РРРР
Day, Month D, YYYY=День, Місяць Д, РРРР
Day, YYYY Month D=День, РРРР Місяць Д
Day, YYYY-MM-DD=День, РРРР-ММ-ДД
DD-MM-YYYY=DD-ММ-РРРР
Deactivate=Деактивувати
Deactivating=Деактивація
Default appdata storage location=Місце зберігання даних програми за замовчуванням
Default critical disk temperature threshold=Порогове значення критичної температури диска за замовчуванням
Default critical disk utilization threshold=Порогове значення критичного використання диска за замовчуванням
Default file system=Файлова система за замовчуванням
Default ISO storage path=Стандартний шлях зберігання ISO
Default network bridge=Мережевий міст за замовчуванням
Default partition format=Формат розділу за замовчуванням
Default SMART attribute notifications=Сповіщення атрибутів SMART за замовчуванням
Default SMART controller type=Тип контролера SMART за замовчуванням
Default SMART notification tolerance level=Рівень допуску сповіщень SMART за замовчуванням
Default SMART notification value=Значення сповіщення SMART за замовчуванням
Default spin down delay=Затримка обертання за замовчуванням
Default VM storage path=Шлях до зберігання VM за замовчуванням
Default warning disk temperature threshold=Порогове значення температури диска з попередженням за замовчуванням
Default warning disk utilization threshold=Типовий поріг завантаження диска
Default Windows VirtIO driver ISO=ISO драйвер Windows VirtIO за замовчуванням
Define a TLS certificate=Визначте сертифікат TLS
Delete directory=Видалити каталог
Delete Image File=Видалити файл Образу
Delete Peer=Видалити Вузол
Delete Tunnel=Видалити тунель
Delete tunnel failed=Не вдалося видалити тунель
Delete vDisk file=Видалити файл vDisk
Delete VLAN=Видалити VLAN
Deny=Заперечити
Desired MTU=Бажаний MTU
Detailed=Детально
Device=Пристрій
DHCP pool=Пул DHCP
directory=каталог
Disk Settings=Налаштування Диска
Display array totals=Відобразити підсумки масиву
Display device name=Відобразити назву пристрою
Display position=Положення дисплея
Display Settings=Налаштування дисплея
Display world-wide-name in device ID=Відображати всесвітню назву в ідентифікаторі пристрою
DNS Propagation is PENDING=Поширення DNS ОЧІКУЄ
DNS Rebinding Protection is ENABLED=Захист від повторного прив’язування DNS УВІМКНЕНО
DNS servers=DNS-сервери
docker containers on custom networks need static routing=Докер-контейнери в користувацьких мережах потребують статичної маршрутизації
Docker custom network type=Спеціальний тип мережі Docker
Docker data-root=Корінь даних Docker
Docker directory=Каталог Docker
Docker LOG maximum file size=Максимальний розмір файлу LOG Docker
Docker LOG number of files=Кількість файлів у журналі Docker
Docker LOG rotation=Ротація журналу Docker
Docker only=Тільки Docker
Docker service=Сервіс Docker
Docker Stop Timeout=Тайм-аут зупинки Docker
Docker update notification=Повідомлення про оновлення Docker
Docker update=Оновлення Docker
Docker vDisk location=Розташування Docker vDisk
Docker vDisk size=Розмір vDisk Docker
Docker version=Версія Docker
Docker VMs=Docker + VMs
Docker volume info=Інформація про об'єм Docker
Docker will be available after Array is Started=Docker буде доступний після запуску масиву
Docker=
Download Windows VirtIO driver ISO=Завантажте ISO драйвер Windows VirtIO
Downloading=Завантаження
Downstream=
Drag-n-drop a PNG file or click the image at the left=Перетягніть файл PNG або клацніть на зображення ліворуч
Dumb=
Duplicate port entered=Введено дублікат порту
Dynamix color theme=Тема кольорів Dynamix
eg=e.g.
Email recipients=Одержувачі електронної пошти
Email subject prefix=Префікс теми електронного листа
Email=Електронна пошта
enable advanced settings view=увімкнути перегляд розширених налаштувань
Enable auto start=Увімкнути автозапуск
Enable bonding=Увімкнути зв’язування
Enable bridging=Увімкнути перехід
Enable disk shares=Увімкнути спільні диски
Enable Docker=Увімкніть Docker
Enable NetBIOS=Увімкніть NetBIOS
Enable NFS=Увімкніть NFS
Enable SMB=Увімкнути SMB
Enable SMB Multi Channel=Увімкнути багатоканальний SMB
Enable spinup groups=Увімкнути групи розкрутки
Enable user shares=Увімкнути спільний доступ користувачів
Enable VLANs=Увімкнути VLAN
Enable VMs=Увімкнути VMs
Enable WSD=Увімкнути WSD
encrypted=зашифрований
Enhanced macOS interoperability=Покращена сумісність з macOS
ensure the peer network is different from=переконайтеся, що однорангова мережа відрізняється від
ensure the peer networks are different from=переконайтеся, що однорангові мережі відрізняються від
Enter route + gateway + metric=Введіть маршрут + шлюз + метрику
Ether=
Ethernet Port=Порт Ethernet
Event=Подія
Every 2 hours=Кожні 2 години
Every 3 hours=Кожні 3 години
Every 4 hours=Кожні 4 години
Every 6 hours=Кожні 5 години
Every 8 hours=Кожні 6 години
Every day=Кожен день
Every hour=Щогодини
Every month=Щомісяця
Every week=Щотижня
exceeds Disk Shutdown=перевищує вимкнення диска
Excluded disks=Виключені диск(и)
Execution error=Помилка виконання
Fahrenheit=Фаренгейта
Failed to open=Не вдалося відкрити
Failed to stop=Не вдалося зупинити
Failure to do so may result in your docker image suffering corruption at a later time=Якщо цього не зробити, це може призвести до того, що ваш образ Docker пізніше буде пошкоджено
First day=Перший день
First week=Перший тиждень
Flash backup=
Font size=Розмір шрифту
Fourth week=Четвертий тиждень
FTP server=FTP-сервер
FTP Server=FTP-Сервер
FTP users=Користувач(и) FTP
Full Balance recommended=Рекомендується повний баланс
gateway name or address=ім'я або адресу шлюзу
Gateway=Шлюз
Generate Key=Згенерувати ключ
Generate Keypair=Створити пару ключів
Global Share Settings=Глобальні налаштування спільного доступу
Global SMART Settings=Глобальні налаштування SMART
Header custom background color=Користувацький колір фону заголовка
Header custom meta text color=Колір власного метатексту заголовка
Header custom secondary text color=Користувацький колір додаткового тексту заголовка
Header custom text color=Нестандартний колір тексту заголовку
Header menu=Заголовок меню
Header show description=Опис показу заголовка
HHMM=ЧЧ:ММ
Hibernate VMs=Гібернація VMs
Hide dot files=Приховати файли з точкою
Host access to custom networks=Доступ хосту до користувацьких мереж
hosts=хостів
Hourly=Щогодини
HTML color code of 3 or 6 hexadecimal digits=Код кольору HTML із 3 або 6 шістнадцяткових цифр
HTTP port=порт HTTP
HTTPS port=порт HTTPS
Huge=Величезний
Identification=Ідентифікація
Import Tunnel=Імпортувати Тунель
Importance=Важливість
In most cases, this should be your public WAN IPv4 instead=У більшості випадків це має бути ваш загальнодоступний WAN IPv4
In most cases, this should be your public WAN IPv4=У більшості випадків це має бути ваш загальнодоступний WAN IPv4
In most cases, this should be your public WAN IPv6 instead=У більшості випадків це має бути ваш загальнодоступний WAN IPv6
In most cases, this should be your public WAN IPv6=У більшості випадків це має бути ваш загальнодоступний WAN IPv6
inactive=неактивний
Included disks=Включений диск(и)
Interface description=Опис інтерфейсу
Interface Rules=Правила інтерфейсу
Invalid data=Недійсні дані
Invalid email address=Невірна адреса електронної пошти
Invalid IPv4 gateway=Недійсний шлюз IPv4
Invalid IPv4 range=Недійсний діапазон IPv4
Invalid IPv4 subnet=Недійсна підмережа IPv4
Invalid IPv6 gateway=Недійсний шлюз IPv6
Invalid IPv6 range=Недійсний діапазон IPv6
Invalid IPv6 subnet=Недійсна підмережа IPv6
Invalid pool address=Недійсна адреса пулу
Invalid subnet size=Недійсний розмір підмережі
IP address or FQDN=IP-адреса або FQDN
IPv4 address A.B.C.D=IPv4-адреса A.B.C.D
IPv4 address assignment=Призначення адреси IPv4
IPv4 address=IPv4 адреса
IPv4 custom network on interface=Спеціальна мережа IPv4 на інтерфейсі
IPv4 default gateway=Шлюз IPv4 за замовчуванням
IPv4 DNS server assignment=Призначення DNS-сервера IPv4
IPv4 DNS server=DNS-сервер IPv4
IPv4 IPv6=IPv4 + IPv6
IPv4 network=мережа IPv4
IPv4 only=Тільки IPv4
IPv4nn or IPv6nn route=IPv4/nn або IPv6/nn маршрут
IPv6 address assignment=Призначення адреси IPv6
IPv6 address nnnnxxxxyyyy=IPv6-адреса nnnn:xxxx::yyyy
IPv6 address=IPv6 адреса
IPv6 custom network on interface=Спеціальна мережа IPv6 на інтерфейсі
IPv6 default gateway=Шлюз за замовчуванням IPv6
IPv6 DNS server assignment=Призначення DNS-сервера IPv6
IPv6 DNS server=DNS-сервер IPv6
IPv6 network=мережа IPv6
IPv6 only=Тільки IPv6
IPv6 privacy extensions=Розширення конфіденційності IPv6
ipvlan=ipvlan
is down=не працює
is not in the=не знаходиться в
Isolated CPUs=Ізольовані CPUs
Isolation=Ізоляція
Join=Приєднуйтесь
Key=Key
kyber=kyber
LAN hub spoke access=LAN-концентратор або зіркоподібний доступ
LAN to LAN access=Доступ LAN до LAN
Language update notification=Повідомлення про оновлення мови
Language update=Оновлення мови
Language=Мова
Large=Великий
Last day=Останній день
Last handshake=Останнє рукостискання
Last week=Минулого тижня
LE Cert Provisioned successfully=Сертифікат LE успішно надано
Leave=Залишати
Libvirt Log=Журнал Libvirt
Libvirt storage location=Місце зберігання Libvirt
Libvirt vdisk size=Розмір vdisk Libvirt
Libvirt version=Версія Libvirt
Libvirt volume info=Інформація про об'єм Libvirt
License key required=Потрібен ліцензійний ключ
List of peers=Список пірів
List of VLANs contains duplicate VLAN numbers=Список VLAN містить повторювані номери VLAN
Listing height=Висота списку
Loading=Завантаження
Local endpoint=Локальна кінцева точка
Local gateway uses UPnP=Локальний шлюз використовує UPnP
Local master=Локальний майстер
Local name=Локальна назва
Local private key=Локальний закритий ключ
Local public key=Локальний відкритий ключ
Local server configuration=Конфігурація локального сервера
Local server uses NAT=Локальний сервер використовує NAT
Local syslog folder=Локальна папка системного журналу
Local syslog maximum file size=Максимальний розмір файлу локального системного журналу
Local syslog number of files=Кількість файлів у локальному системному журналі
Local syslog port=Локальний порт системного журналу
Local syslog rotation=Локальна ротація системного журналу
Local syslog server=Локальний сервер системного журналу
Local TLD=Локальний TLD
Local tunnel address IPv6=Адреса локального тунелю IPv6
Local tunnel address=Локальна адреса тунелю
Local tunnel firewall=Локальний тунельний брандмауер
Local tunnel network pool IPv6=Пул локальної тунельної мережі IPv6
Local tunnel network pool=Пул локальної тунельної мережі
Lost communication=Втрачений зв’язок
MAC address mismatch=Невідповідність MAC-адреси
MAC address=MAC-адреса
macvlan=macvlan
Mail server port=Порт поштового сервера
Mail server=Поштовий сервер
Manage password=Керувати паролем
Manage=Керувати
Management Access=Доступ до керування
mandatory=обов'язковим
Manual=Посібник
member of=учасником
Metric=Метрична
Mirror syslog to flash=Дзеркало системного журналу для flash
Missing subnet size=Відсутній розмір підмережі
MM-DD-YYYY=ММ-ДД-РРРР
ModBus=ModBus
Modify with caution unable to validate path until Array is Started=Змінюйте обережно: неможливо перевірити шлях, доки не буде запущено масив
Month of the year=Місяць року
Monthly=Щомісячно
Move now=Перемістити зараз
Mover is running=Виконується переміщення
Mover logging=Ведення журналу переміщення
Mover schedule=Графік переміщення
Mover Settings=Налаштування Переміщення
mq-deadline=mq-дедлайн
MTU size=Розмір MTU
Multi-function=Багатофункціональний
Must be signed in to Unraidnet to provision cert=Щоб надати сертифікат, необхідно ввійти в Unraid.net
name or ip address=ім'я або ip-адреса
Net=Мережа
Network protocol=Мережевий протокол
Network Services=Мережеві Сервіси
Network Settings=Мережеві Налаштування
Never check=Ніколи не перевіряйте
Never send=Ніколи не надсилайте
New date and time=Нова дата і час
NFS=NFS
No Balance required=
No battery detected=
No Cache device present=
No Cache disk present=
No change to report=
No CPU pinning available. Docker service must be started=
No CPU pinning available. VM service must be started=
no name=
No Parity disk present=
No Reply=
Nominal Power=
Non-tabbed=
Not activated=
Not allowed to assign ZERO cores=
Not compatible with NetBIOS=
not configured=
Not present=
not received=
not set=
Not up-to-date=
not used=
Nothing to do=
Notices=
Notification Agents=
Notification entity=
Notification Settings=
Notifications display=
NTP server=
Number format=
Number scaling=
Obtaining DNSv4 server=
Obtaining DNSv6 server=
Obtaining IPv4 address=
Obtaining IPv4 gateway=
Obtaining IPv6 address=
Obtaining IPv6 gateway=
obtaining=
On battery=
One or more paths do not exist=
Online boost=Online (boost)
Online trim=Online (trim)
Online=
Only alphanumeric characters=
Only PNG images are allowed=
Oops=
optional metric lowest is preferred, 0 is no default gateway=optional metric (lowest is preferred, 0 is no default gateway)
optional metric lowest is preferred=optional metric (lowest is preferred)
or=
Page view=
Parity Check=
Password=
Path does not exist=
PCIe ACS override=
PCnet=
Peer allowed IPs=
Peer DNS server=
Peer endpoint=
Peer name=
Peer preshared key=
Peer private key=
Peer public key=
Peer tunnel address IPv6=
Peer tunnel address=
Peer type of access=
Peer update required=
Persistent keepalive=
Ping=
Placement of Users menu=
Please consider re-applying all configurations=
Please disable the VM function=
Please do this NOW=
Please enter a valid gateway=
Please enter a valid range=
Please enter a valid sending email address=
Please enter a valid subnet=
Please note that the flash backup is not encrypted at this time=Please note that the flash backup is not encrypted at this time.
Please Reboot system to make new rules active=Please **Reboot** system to make new rules active
Plugins update notification=
Plugins update=
Pool address is out of range=
Pool subnet size is not defined=
Pool subnet size is too large=
Port %s is already in use by other services=
Port %s is duplicated=
Port %s is out of range minimum 1 maximum 65535=Port %s is out of range (minimum 1 maximum 65535)
Port already in use=
Port Down=
Port out of range=
Port Up=
Preserve user defined networks=
Preset service=
Priority in header=
Protocol=
Provision=
QEMU version=
readmodifywrite=read/modify/write
recommended=
reconstruct write=
Refreshing=
Registration key required=
Reinitialize=
Reinitializing=
Remark configure your router with port forwarding of port=Remark: configure your router with port forwarding of port
Remark=
Remote access to LAN=
Remote access to server=
Remote peer configuration=
Remote syslog port=
Remote syslog server=
Remote tunneled access=
Remove Windows VirtIO driver ISO=
Replied=
resolution=
Restore default image=
Route=
Routing Table=
Rule=
Rules contain duplicate MAC address assignments=
Rules=
Runtime left to initiate shutdown=
Runtime Left=
Samba extra configuration=
Scheduled parity check=
Scheduler=
Scrub=
Scrub schedule=
Second week=
See Help for more details and workarounds=
see interface=
Send crash information to Unraid developers=
Send every hour=
Send every two hours=
Send four times a day=
Send once a day=
Send once a month=
Send once a week=
Send three times a day=
Send twice a day=
Sending email address=
Server hub spoke access=Server hub & spoke access
Server name=
Server to server access=
Server was unable to provision SSL certificate=
Set password=
Setting disabled in safe mode=Setting disabled in **safe mode**
Settings menu=
Show array utilization indicator=
Show banner=
Show banner background color fade=
Show Dashboard apps=
Show Peer Config=
Shutdown time-out=
Shutdown VMs=
shutdown=
Sign In to Unraidnet required=Sign In to Unraid.net required
Simple=
Small=
Smart=
SMB Extras=
SMB Settings=
SMB=
SMTP Settings=
SNMP=
Sorry, an error occurred in processing your SSL certificate=
Sorry, an error occurred updating unraidnet DNS records=Sorry, an error occurred updating unraid.net DNS records
SSH port=
Start APC UPS daemon=
Start page=
Static=
Stop %s to make changes, see=Stop **%s** to make changes, see
Stop corresponding docker containers=
Store notifications to flash=
Subject=
Subnet=
subnet=
success=
Summarized=
Syslog Server=
System notifications=
System Setting=
System Settings=
Tabbed=
TCP=
TELNET port=
Temperature unit=
Template Authoring Mode=
Terminal font size=
Test running=
Test=
Text - Bar color=Text - Bar (color)
Text - Bar gray=Text - Bar (gray)
Text=
The Local endpoint does not resolve to an IPv4 address=
The Local endpoint does not resolve to an IPv6 address=
The Local endpoint resolves to=
The Local tunnel network pool cannot be in=
The Local tunnel network pool IPv6 cannot be in=
Third week=
This is required to create VMs in KVM=
this mode requires a network switch with proper setup and support=
this must be the only peer in the tunnel and sole active tunnel when in use=
This removes any connections running over this tunnel=
This Unraid Server was unreachable from the outside=
Time format=
Time of the day=
Time on battery before shutdown=
Time zone=
time-out=
Timestamp=
TLS certificate location=
to=
Toggle keys=
Toggle thread to containers=
Toggle view=
top-left=
top-right=
Tunable enable Direct IO=Tunable (enable Direct IO)
Tunable enable NCQ=Tunable (enable NCQ)
Tunable fuse_remember=Tunable (fuse_remember)
Tunable md_num_stripes=Tunable (md_num_stripes)
Tunable md_queue_limit=Tunable (md_queue_limit)
Tunable md_sync_limit=Tunable (md_sync_limit)
Tunable md_write_method=Tunable (md_write_method)
Tunable nr_requests=Tunable (nr_requests)
Tunable poll_attributes=Tunable (poll_attributes)
Tunable scheduler=Tunable (scheduler)
Tunable support Hard Links=Tunable (support Hard Links)
Tunnel has running containers attached=
tunnel is inactive=
Turn off UPS after shutdown=
UDP=
Unable to register this Unraid Server=
; Keep the original plugin name in settings
Unassigned Devices=Unassigned Devices
Unraid OS update notification=
Unraid OS update=
Unraidnet account status=Unraid.net account status
Unraidnet Status=Unraid.net Status
Update DNS=
updating=
Updating=
Upgrade Cert=
UPnP forwarding not set=UPnP: forwarding not set
UPnP state changed to=
UPnP tunnel is inactive=UPnP: tunnel is inactive
Upon host shutdown=
UPS cable=
UPS Details=
UPS Load=
UPS Settings=
UPS Status=
UPS type=
USB=
Use image name dockerimg or docker-xfsimg or select a folder=Use image name docker.img or docker-xfs.img or select a folder
Use NTP=
Use only letters A-Z, digits or space,dash,underscore=
Use SSH=
Use SSLTLS=Use SSL/TLS
Use STARTTLS=
Use TELNET=
Use UPnP=
Used Free columns=Used / Free columns
User Preferences=
User root=User 'root'
User shares not enabled=
User Utilities=
Username=
user-set=
value must be a number=
Value=
Very large=
Very small=
VFIO allow unsafe interrupts=
View libvirt log=
View Local Config=
View Peer Config=
view=
VLAN assignment mismatch=
VLAN number=
VM Manager=
VM manager=
VM Settings A reboot is required to apply changes=VM Settings: A reboot is required to apply changes
VM shutdown time-out=
VM=VM
VMs only=
VMs will be available after Array is Started=
VPN Manager=
VPN tunnel for docker containers only=
VPN tunneled access=
VPN tunneled access for docker=
VPN tunneled access for system=
WAN Port=
Warnings=
Watts=
Week of the month=
Weekly=
WireGuard Configuration=
Workgroup Settings=
Workgroup=
Write corrections to parity disk=
WSD options experimental=WSD options [experimental]
xfs vDisk=xfs vDisk
Yearly=Щорічно
You must be signed in to Unraidnet in order to generate an Unraidnet SSL certificate=You must be signed in to Unraid.net in order to generate an Unraid.net SSL certificate
Your existing Docker image file needs to be recreated due to an issue from an earlier beta of Unraid 6=
Your hardware does not have Intel VT-x or AMD-V capability=
Your Lets Encrypt SSL Certificate has been provisioned and a DNS record for local IP address=Your Let's Encrypt SSL Certificate has been provisioned and a DNS record for local IP address
Your Lets Encrypt SSL Certificate has been renewed=Your Let's Encrypt SSL Certificate has been renewed
Your local IP address %s has been updated for unraidnet=Your local IP address %s has been updated for unraid.net
Your router or DNS server has DNS rebinding protection enabled, preventing=
Your server has been registered=
Your Unraid Server is reachable from the internet=
YYYY-MM-DD=РРРР-ММ-ДД

; My Servers plugin
Are you sure you want pause communication with your remote flash backup on unraidnet=Ви впевнені, що хочете призупинити зв’язок із віддаленим резервним копіюванням на unraid.net?
Are you sure you want to erase all change history in both local and unraidnet remote=Ви впевнені, що хочете стерти всю історію змін як на локальному, так і на віддаленому unraid.net?
Disabled until you Provision an unraidnet SSL Cert and set SSL-TLS to Auto=Вимкнено, доки ви не надасте сертифікат unraid.net SSL і не встановите SSL-TLS на Авто
Disabled until you Provision an unraidnet SSL Cert=Вимкнено, доки ви не надасте сертифікат unraid.net SSL
Disabled until your root user account is password-protected=Вимкнено, доки ваш обліковий запис користувача root не буде захищено паролем
Enable Transparent 2FA for Local Access=Увімкнути прозору 2FA для локального доступу
Enable Transparent 2FA for Remote Access=Увімкнути прозору 2FA для віддаленого доступу
In order to activate Flash Backup there must be at least 1GB of free space on your flash drive=Щоб активувати флеш-резервну копію, на флеш-накопичувачі має бути не менше 1 ГБ вільного місця.
Local T2FA requires a myunraidnet certificate=Для локального T2FA потрібен сертифікат *.myunraid.net
Local T2FA requires Unraid 610 or higher and a myunraidnet certificate=Для локального T2FA потрібен Unraid 6.10 або вище та сертифікат *.myunraid.net
Local T2FA requires Unraid 610 or higher=Для локального T2FA потрібен Unraid 6.10 або вище
Local T2FA requires Use SSLTLS to be Auto and a myunraidnet certificate=Для локального T2FA потрібно використовувати SSL/TLS, щоб бути автоматичним і сертифікат *.myunraid.net
Local T2FA requires Use SSLTLS to be Auto and Unraid 610 or higher=Для локального T2FA потрібно, щоб параметр Use SSL/TLS був Автоматичний та Unraid 6.10 або вище
Local T2FA requires Use SSLTLS to be Auto, Unraid 610 or higher, and a myunraidnet certificate=Місцевий T2FA вимагає, щоб використання SSL/TLS було автоматично, Unraid 6.10 або вище, а також сертифікат *.myunraid.net
Local T2FA requires Use SSLTLS to be Auto=Для локального T2FA потрібно використовувати SSL/TLS, щоб було автоматично
More information=Більше інформації.
port=порт
Remote T2FA requires a myunraidnet certificate=Для віддаленого T2FA потрібен сертифікат *.myunraid.net
Remote T2FA requires Remote Access to be enabled and a myunraidnet certificate=Для віддаленого T2FA потрібно ввімкнути віддалений доступ і сертифікат *.myunraid.net
Remote T2FA requires Remote Access to be enabled and Unraid 610 or higher=Для віддаленого T2FA потрібно ввімкнути віддалений доступ і Unraid 6.10 або новішої версії
Remote T2FA requires Remote Access to be enabled, Unraid 610 or higher, and a myunraidnet certificate=Для віддаленого T2FA потрібно ввімкнути віддалений доступ, Unraid 6.10 або новішої версії та сертифікат *.myunraid.net
Remote T2FA requires Remote Access to be enabled=Для віддаленого T2FA потрібно ввімкнути віддалений доступ
Remote T2FA requires Unraid 610 or higher and a myunraidnet certificate=Для віддаленого T2FA потрібні Unraid 6.10 або новішої версії та сертифікат *.myunraid.net
Remote T2FA requires Unraid 610 or higher=Для віддаленого T2FA потрібен Unraid 6.10 або новішої версії
The Unraid server is unreachable from outside your network Be sure you have configured your router to forward port=Сервер Unraid недоступний з-за меж вашої мережі. Переконайтеся, що ви налаштували маршрутизатор на переадресацію порту
to the Unraid server at=на сервер Unraid за адресою
Transient errors in this log can be ignored unless you are having issues=Тимчасові помилки в цьому журналі можна ігнорувати, якщо у вас не виникли проблеми
Unraid API extra origins=Додаткові джерела API Unraid
View Flash Backup Error Log=Переглянути журнал помилок Flash Backup

; Note: June 11, 2022 - 274 missing translations
