A disk must be cleared of all partitions before it can be precleared=Диск має бути очищений від усіх розділів, перш ніж його можна буде попередньо очистити
Cannot Preclear=Не вдається виконати попереднє очищення
Clear Disk=Очистити диск
Clear Signature=Очистити сигнатуру
Clear Stats=Очистити статистику
Click to show reports=Натисніть, щоб показати звіти
Concurrent Sessions=Паралельні сеанси
Cycles=Цикли
Device Model=Модель пристрою
Disk Log Information=Інформація журналу диска
Disk Size=Розмір диска
Download Logs=Завантажити журнали
Enable Testing for debugging=Увімкнути тестування для налагодження
Fast Post-read=Швидке читання після запису
Firmware=Прошивка
Fix Preclear=Виправити попереднє очищення
Identification=Ідентифікація
If you set a queue limit, all running preclear sessions above that limit will be paused and remain in the queue until a session finishes=Якщо ви встановите ліміт черги, усі запущені сеанси попереднього очищення понад цей ліміт буде призупинено й вони залишатимуться в черзі, доки не завершиться один із сеансів
Notifications=Сповіщення
On every cycle and step end=Наприкінці кожного циклу та кроку
On every 25% of progress=Кожні 25% прогресу
On every cycle end=Наприкінці кожного циклу
On preclear end=Після завершення попереднього очищення
Operation=Операція
Post-read Verify=Перевірка читання після запису
Preclear Disks=Попереднє очищення дисків
Preclear Disk Log=Журнал попереднього очищення диска
Preclear Log=Журнал попереднього очищення
Preclear Status=Стан попереднього очищення
Preview Progress=Попередній перегляд прогресу
Read size=Розмір читання
Remove Report=Видалити звіт
Resume all Sessions=Відновити всі сеанси
Resume Preclear=Відновити попереднє очищення
Preview Progress Report=Звіт попереднього перегляду прогресу
Select Disks=Вибрати диски
Serial Number=Серійний номер
Set Preclear Queue=Встановити чергу попереднього очищення
Show Preclear Report=Показати звіт попереднього очищення
Skip Pre-read=Пропустити читання перед записом
Skip Post-Read=Пропустити читання після запису
Start Multiple Sessions=Запустити кілька сеансів
Start New=Почати новий
Start Preclear=Почати попереднє очищення
Stop all Sessions=Зупинити всі сеанси
Stop Preclear=Зупинити попереднє очищення
Temp=Температура
Testing=Тестування
There are no disks that can be precleared=Немає дисків, які можна попередньо очистити
Verify Signature=Перевірити сигнатуру
Write size=Розмір запису
You can use Unassigned Devices to clear the disk=Ви можете використати Unassigned Devices, щоб очистити диск

:preclear_general_help_plug:
> Попереднє очищення (Pre-clear) в Unassigned Devices можна використовувати для підготовки дисків до додавання в масив, очищення дисків перед утилізацією та виконання стрес-тестів перед використанням дисків у масиві.
>
> Тільки диски, які не використовуються в масиві та не мають розділів з файловими системами, будуть перелічені як кандидати на попереднє очищення.
>
> Коли диск попередньо очищується, ви можете відстежувати стан на цій сторінці, на сторінці «Непризначені пристрої» або за допомогою значка стану попереднього очищення внизу веб-сторінки Unraid.
> 
> Є кілька варіантів виконання попереднього-очищення:
>
> Скрипт **Enhanced**, автор — користувач **gfjardim**, має перевагу в тому, що підтримує розширені функції, як-от **пауза** та відновлення (resume) pre-clear. Також він веде детальний журнал.
>
> Варіант **Docker** стосується Docker-контейнера binhex, який виконує pre-clear. Перевага в тому, що pre-clear ізольований усередині контейнера.
>
> Операції попереднього-очищення:
>
> + Clear Disk - Диск очищується, і на нього записується підпис Unraid. Це створить на диску порожній розділ.
> + Erase Disk - Повністю стерти диск, записавши всюди нулі. Підпис pre-clear буде видалено.
> + Erase and Clear Disk - На диск записуються випадкові шаблони, а потім нулі. Це гарний вибір для диска, який планується утилізувати, щоб прибрати всі сліди файлів.
> + Verify Signature - Перевірити підпис диска.
> + Verify Disk - Перевірити підпис диска та переконатися, що диск заповнений нулями.
> + Post-read Verify - Виконати післячитальну перевірку (post-read verify) для перевірки диска.
> + Clear Signature - Видалити підпис pre-clear з диска.
>
> Текст <em style='color:#00BE37;'>Pre-cleared</em> поруч із серійним номером диска означає, що диск має підпис pre-clear. Це відображається лише тоді, коли диск пройшов pre-clear і статистику Pre-clear Stats було видалено.
:end
