Cancel=Скасувати

; My PSAs / banners
Happy New Year=Щасливого Нового Року
Happy Holidays from Andrew, Tracey, and family=Веселих свят від Ендрю, Трейсі та сім'ї
Please Enjoy Responsibly=Будь ласка, насолоджуйтесь відповідально
Popup Blocked CA requires popups to be enabled under certain circumstances You must white list your server within your browser to allow popups=Спливаючі вікна заблоковані CA вимагає, щоб спливаючі вікна були ввімкнені за певних обставин. Щоб дозволити спливаючі вікна, ваш сервер повинен бути в білому списку у вашому браузері
Docker Service Not Enabled - Only Plugins Available To Be Installed Or Managed=Служба Docker не ввімкнена – лише плагіни доступні для встановлення чи керування
Docker system failed to start - Only Plugins Available To Be Installed Or Managed=Не вдалося запустити систему Docker – доступні лише плагіни для встановлення чи керування
Array not started - Only Plugins Available To Be Installed Or Managed=Масив не запущено – доступні лише плагіни для встановлення чи керування
Community Applications works best when cookies are enabled in your browser Certain features may not be available=Програми спільноти найкраще працюють, коли у вашому браузері ввімкнено файли cookie. Деякі функції можуть бути недоступними
Backup Server Active Some icons may not appear, and plugin installations may be affected=Сервер резервного копіювання активний Деякі піктограми можуть не відображатися, і це може вплинути на встановлення плагінів
Debugging enabled This significantly increases the memory used by your browser=Увімкнено налагодження. Це значно збільшує обсяг пам’яті, який використовує ваш браузер
Browser translation detected Display issues may result=Виявлено переклад браузера. Можуть виникнути проблеми з відображенням
Running Background Application Tests=Запуск тестів фонової програми
Action Centre Enabled=Центрі Підтримки увімкнено

; Sorting Options
Sort By=Сортувати за
Name Ascending=За зростанням Назви
Name Descending=За спаданням Назви
Downloads=Завантаження
Date Added=Дата Встановлення
Number Of Apps=Кількість Програм
; Initial disclaimer translations
Disclaimer=Відмова від відповідальності
All applications listed here are 3rd party additions to Unraid Neither the authors of Community Applications nor Limetech make any warranty as to the suitability of any application listed here=Усі програми, перелічені тут, є сторонніми додатками до Unraid. Ні автори програм спільноти, ні Limetech не дають жодних гарантій щодо придатності будь-якої програми, переліченої тут
Every attempt is made to ensure that only safe and compatible applications are present=Зроблено всі зусилля для забезпечення наявності лише безпечних і сумісних програм
Application Policy=Політика застосування
I Understand=Я розумію
Installations of apps disabled You must accept the warning to be able to install applications=Встановлення програм вимкнено. Щоб мати можливість встановлювати програми, потрібно прийняти попередження
Click here=Натисніть тут
%s Results Per Page=%s Результатів на Сторінку
Results Per Page: %s=Результатів на Сторінку: %s

; Plugin Disclaimer
Community Applications contains both docker containers and plugin applications Plugins are designed for OS enhancements, and run with full privileges on your system and are clearly identified within CA=Програми спільноти містять як контейнери докерів, так і додатки плагінів. Плагіни розроблені для покращення ОС і працюють з повними привілеями у вашій системі та чітко визначені в CA
Plugin Note=Примітка Плагіна

; Multi Install
Install Plugin Applications=Встановити додатки плагінів
Select all on page=Виберіть все на сторінці
Install Application=Встановити додаток
Install Applications=Встановити додатоки
Update Applications=Оновлення додатоків
Are you sure you want to update %s applications=Ви впевнені, що хочете оновити програми %s
Are you sure you want to install %s docker and %s plugin applications=Ви впевнені, що хочете встановити докер %1$s і додатки плагінів %2$s

; Searches
Search=Пошук
Click Here To Get More Results From DockerHub=Натисніть тут, щоб отримати додаткові результати від DockerHub
No Matching Applications Found=Не знайдено відповідних програм

; Repository Related
%s removed as favourite repository=%s видалено як улюблений репозиторій
%s set as favourite repository=%s встановлено як улюблений репозиторій
Click to remove favourite repository=Натисніть, щоб видалити улюблений репозиторій
Click to set %s as favourite repository=Натисніть, щоб встановити %s як улюблений репозиторій
Search for apps in repository=Пошук програм у репозиторії
No description present=Немає опису
Go to the forum page=Перейдіть на сторінку форуму
Go to the webpage=Перейти на веб-сторінку
Go to reddit=Перейти до reddit
Go to facebook=Перейти до facebook
Go to discord=Перейти до discord
Go to forum profile=Перейти до профілю форуму
Show Profile=Показати профіль
SHOW MORE=ПОКАЗАТИ БІЛЬШЕ
SHOW LESS=ПОКАЗАТИ МЕНШЕ
Read more=Детальніше
Total Applications=Всього заявок
Total Known Downloads=Загальна кількість відомих завантажень
Total Docker Applications=Всього програм Docker
Total Plugin Applications=Всього Додатків Плагінів
Total Languages=Всього мов
Average Downloads Per App=Середня кількість завантажень на додаток
Web Page=Веб-сторінка
Forum=Форум
Forum Profile=Профіль Форуму
Profile=Профіль
Facebook=Facebook
Reddit=Reddit
Twitter=Twitter
Discord=Discord
Search Apps=Пошук Додатків
Registry=Реєстр
Details=Деталі
Added=Додати
; Install Plugin title of openbox
Install Plugin=Установити плагін
Update Plugin=Оновити плагін

Requirements not met=Вимоги не виконані
The requirements for this upgrade have not been met on your system=Вимоги для цього оновлення не були виконані у вашій системі

BACK=НАЗАД

; Remove App from previously installed
Delete Template=Видалити шаблон
Yes, delete it=Так, видаліть

; Uninstall popup
Uninstall Application=Видалити Додаток
Yes uninstall it=Так, видаліть його

; Remove Private Application
Remove Private Application=Видалити приватний додаток
Yes, remove it=Так, видаліть

; App Pinning
Click to pin this application=Натисніть, щоб закріпити цю програму
Click to unpin this application=Натисніть, щоб відкріпити цю програму
Pin App=Закріпити додаток
Unpin App=Відкріпити додаток

; Branch installations
Choose A Branch To Install=Виберіть гілку для встановлення

; Multiple application installs
; no apps selected
Install Selected Applications=Встановіть вибрані Додатки

Yes, install it=Так, встановіть його

; Multi-install popup
Yes, install them=Так, встановити їх
Cookies not enabled Plugins must be separately installed from docker applications=Файли cookie не ввімкнені. Плагіни необхідно встановлювати окремо від програм Docker
Docker applications will be installed utilizing the most recently saved template with no user input on your part=Програми Docker будуть встановлені з використанням останнього збереженого шаблону без введення з вашого боку
Updating Support Links=Оновлення посилань підтримки
Downloading docker icons=Завантаження іконок докерів
Finished Installing If the DONE button did not appear, then you will need to click the red X in the top right corner=Встановлення завершено Якщо кнопка ГОТОВО не з'явилася, вам потрібно буде натиснути червоний X у верхньому правому куті

; error messages
No data was returned It is probable that another browser session has rebooted your server Reloading this browser tab will probably fix this error=
An error occurred Could not find any %s Apps=
Download of appfeed failed=
; the %s here refers to a function being called
Something really went wrong here=
Post the ENTIRE contents of this message in the Community Applications Support Thread=
Unknown error happened Please post a screenshot in the support thread of the Statistics screen=
Something really wrong happened Reloading the Apps tab will probably fix the problem=
This plugin has a duplicated name from another plugin %s This will impact your ability to install both plugins simultaneously=
You have been logged out=
Fatal Flash Drive Error=
This usually means your flash drive is corrupted or has dropped offline The rest of the Unraid GUI will also be affected Post a new thread in the Unraid forums if this error continues=
Fatal Docker Image Error=
Your docker image or folder is either read-only or completely full Issues will result because of this You should create a new post in the Unraid forums and include your diagnostics=
This template is set up to use a custom network You may have to adjust the network or IP address etc to match your system=
One or more ports used by this application are already in use by another service or app running on your server You will need to adjust the host ports accordingly on the template=

; CA Sections Keep the length reasonable
Home=Головна
Installed Apps=Встановлені Додатки
Previous Apps=Попередні Додатки
Pinned Apps=Закріплені Додатки
Favourite Repo=Улюблене репо
Action Centre=Центр дій
Recently Added=Нещодавно додані
Random Apps=Випадкові програм
Top New Installs=Найпопулярніші нові інсталяції
Top Trending Apps=Найпопулярніші програми
Spotlight Apps=Додатки Центра уваги
All Apps=Усі Додатки
Statistics=Статистика
Credits=Заслуга
Support=Підтримка
VERSION=ВЕРСІЯ
Change Log=Журнал змін
Debugging=Налагодження

; Credits
Development=Розробник
Additional Contributions=Додаткові внески
GUI Layout Design=Дизайн макета графічного інтерфейсу
Application Feed=Канал програми
Additional Testing=Додаткове Тестування
Moderation=Модерація
Additional Libraries=Додаткові бібліотеки
Copyright=Авторське право
Translation=Переклад

; Statistics page

unknown=невідомо
Last Change To Application Feed=Остання зміна каналу програми
Docker Applications=Програми Docker
Plugin Applications=Додатки Плагінів
Templates=Шаблони
Official Containers=Офіційні Контейнери
Repositories=Репозиторії
Private Docker Applications=Приватні програми Docker
Invalid Templates=Недійсні Шаблони
Template Errors=Помилки шаблону
Blacklisted Apps=Додатки з чорного списку
Incompatible Applications=Несумісні програми
Deprecated Applications=Застарілі програми
Moderation Entries=Модерація записів
Primary Server=Основний сервер
Backup Server=Сервер резервного копіювання
Installs not allowed from this page=Встановлення з цієї сторінки заборонено

; Statistics Popup
No invalid templates found=Недійсних шаблонів не знайдено
These templates are invalid and the application they are referring to is unknown=Ці шаблони недійсні, а програма, на яку вони посилаються, невідома
No templates were automatically fixed=Жоден шаблон не виправлено автоматично
All of these errors found have been fixed automatically=Усі ці виявлені помилки були виправлені автоматично
Note that many of these errors can be avoided by following the directions=Зауважте, що багатьох із цих помилок можна уникнути, дотримуючись інструкцій
HERE=ТУТ
The following plugins have duplicated filenames and are not able to be installed simultaneously=Наступні плагіни мають дубльовані назви файлів, тому їх неможливо інсталювати одночасно
The following docker applications refer to the same docker repository but may have subtle changes in the template to warrant this=Наступні програми докерів посилаються на те саме сховище докерів, але можуть мати незначні зміни в шаблоні, щоб гарантувати це
If any of these entries are incorrect then contact the moderators of CA to discuss=Якщо будь-який із цих записів неправильний, зверніться до модераторів CA для обговорення
Global Repository Comments=Коментарі глобального сховища
Applied to all applications=(Застосовується до всіх програм)
Individual Application Moderation=Модерація Застосування

; Misc
Community Applications Changelog=Журнал змін додатків спільноти

Each month we highlight some of the amazing work from our community=Щомісяця ми висвітлюємо деякі дивовижні роботи нашої спільноти
Check out these newly added applications from our awesome community=Перегляньте ці нещодавно додані програми від нашої чудової спільноти
Check out these up and coming apps=Перегляньте ці нові програми
These apps have the highest percentage of new installs=Ці програми мають найвищий відсоток нових встановлень
An assortment of randomly chosen apps=Асортимент випадково вибраних програм

; Categories try not to be excessively long This is displayed on the left of CA screen

Backup=Резервне Копіювання
Cloud=Cloud
Crypto Currency=Крипто Валюта
Downloaders=Завантажувачі
Drivers=Драйвери
Game Servers=Ігрові Сервери
Home Automation=Автоматизація Дому
Media Applications=Медіа-Додатки
Books=Книги
Music=Музика
Photos=Фотографії
Video=Відео
Other=Інші
Media Servers=Медіа-Сервери
Network Services=Мережеві Сервіси
DNS=DNS
FTP=FTP
Management=Менеджмент
Messenger=Месенджер
Proxy=Proxy
VOIP=VOIP
VPN=VPN
Web=Web
Privacy=Приватність
Productivity=Продуктивність
Security=Безпека
Spotlight=Центр уваги
Tools Utilities=Засоби / Утиліти
System=Система
Themes=Теми
Utilities=Утиліти
Private Apps=Приватні програми
Uncategorized=Без категорії

; Categories displayed within a popup or on the card.  Where an entry exists after the "=" it is not translated, but rather how it should look
GameServers=Ігрові сервери
HomeAutomation=Автоматизація Дому
MediaApp=Медіа-Додатки
MediaAppBooks=MediaApp:Books
MediaAppMusic=MediaApp:Music
MediaAppPhotos=MediaApp:Photos
MediaAppVideo=MediaApp:Video
MediaAppOther=MediaApp:Other
MediaServer=Медіа Сервер
MediaServerBooks=MediaServer:Books
MediaServerMusic=MediaServer:Music
MediaServerPhotos=MediaServer:Photos
MediaServerVideo=MediaServer:Video
MediaServerOther=MediaServer:Other
Network=Мережа
NetworkDNS=Network:DNS
NetworkFTP=Network:FTP
NetworkManagement=Network:Management
NetworkProxy=Network:Proxy
NetworkVOIP=Network:VOIP
NetworkVPN=Network:VPN
NetworkPrivacy=Network:Privacy
NetworkWeb=Network:Web
NetworkOther=Network:Other
ToolsSystem=Tools:System
ToolsThemes=Tools:Themes
ToolsUtilities=Tools:Utilities
OtherUncategorized=Other:Uncategorized
and %s more=і ще %s

; App Popup Related
This application template has been blacklisted=Цю програму / шаблон занесено до чорного списку
This application template has been deprecated=Цю програму / шаблон застарілий
This application has additional requirements=Ця програма має додаткові вимоги
Additional Requirements=Додаткові вимоги
Donate To Author=Пожертвувати автору
Donate To Maintainer=Пожертвувати супроводжуючому
CLOSE=ЗАКРИТИ
Author=Автор
Maintainer=Супроводжувач
DockerHub=DockerHub
Application Template=
DockerHub Stars=
Added to CA=
Date Updated=
Current Version=
Min OS=
Max OS=
Total Downloads=
Licence=
Ranked #%s=
; as in Trending up or down arrow
Trending %s=
; as in As of some date
As of %s=(As of %s)
Play Video=
Play Video %s=
This application is not compatible with your version of Unraid=
Another browser tab or device has updated the displayed templates Some actions are not available=Another browser tab or device has updated the displayed templates. Some actions are not available
WebUI=
Reinstall=
Reinstall From Previous Apps=
Install=
Uninstall=
Project=
Read Me First=
Install second instance=
Install Using The Templates Default Tag=Install Using The Template's Default Tag
Moderator Comments=Moderator Comments:
Note not all authors keep up to date on change logs=
Note not all maintainers keep up to date on change logs=
Last Update=
Note All statistics are only gathered every 30 days=
;the following if using a space you MUST use nbsp but keep it down to one word if at all possible
Donate=
Currently Installed Version=
Install The Update=
; as in you have the latest version already installed
Latest Version=
Multi Language Support=
Support Forum=
; as in more than 100000
More than %s=
Remove from Previous Apps=
Remove=
See All Apps=
Favourite=
Application Type=

; Graphs
Trend Per Month=Тенденція за місяць
Downloads Per Month=Завантаження на місяць

; Multi install script
Installing docker applications %s=Встановлення docker-програм %s
Starting %s=Запуск %s
%s failed to start You should install it by itself to fix the errors=Не вдалося запустити %s. Ви повинні встановити його самостійно, щоб виправити помилки
Setting installed applications to autostart=Налаштування встановлених програм на автозапуск
Docker Application Installation finished=Встановлення програми Docker завершено

; Application Cards
Actions=Дії
This application is a driver plugin=Ця програма є драйвером (плагіном)
This is a language pack=Це мовний пакет
This application is a docker container=Ця програма є docker-контейнером
This application is a plugin=Ця програма є плагіном
This is a spotlight application=Це програма для залучення уваги
This is your favourite repository=Це ваше улюблене сховище
This application is from your favourite repository=Ця програма з вашого улюбленого сховища
This application is pinned for later viewing=Ця програма закріплена для подальшого перегляду
Private Application=Приватне Застосування
Remove Application From List=Видалити програму зі списку
Check off to select multiple reinstalls=Поставте прапорець, щоб вибрати кілька повторних інсталяцій
Go to the plugin settings=Перейдіть до налаштувань плагіна
Click to reinstall the application using default values=Клацніть, щоб перевстановити програму, використовуючи значення за замовчуванням
Click to edit the application values=Натисніть, щоб редагувати значення програми
Click to reinstall=Натисніть, щоб перевстановити
Click to install=Натисніть, щоб встановити
Click to go to the WebUI=Натисніть, щоб перейти до WebUI
This application template has been deprecated=Цей шаблон програми застарів
This application template has been blacklisted=Цей шаблон програми внесено до чорного списку
Click info to see the notes regarding this application=Натисніть інформацію, щоб переглянути примітки щодо цієї програми
This application has additional requirements=Ця програма має додаткові вимоги
BETA=БЕТА
INSTALLED=ВСТАНОВЛЕНО
OFFICIAL=ОФІЦІЙНИЙ
UPDATED=ОНОВЛЕНО
This is an official container=Це офіційний контейнер
Digitally Signed=Цифровий підпис
This container is digitally signed=Цей контейнер має цифровий підпис
Docker Hub=Docker Hub
NOTE You must visit the dockerHub page to gather the information required to install correctly=ПРИМІТКА Ви повинні відвідати сторінку dockerHub, щоб зібрати інформацію, необхідну для правильного встановлення
Show CA templates=Показати шаблони CA
Deprecated=Застаріле
Incompatible=Несумісні
Blacklisted=Чорний список
Template Exists=Шаблон існує
Template already exists in Apps=Шаблон уже існує в Додатках
; eg: LinuxServer Repository
%s Repository=%s Репозиторій
; eg: Squid's Repository
%s's Repository=%s's Репозиторій

Info=Інформація
Attention=Увага
Repository=Репозиторій
Why we picked it=Чому ми вибрали це
Application Spotlight %s=Програма в центрі уваги %s
Unraid Staff=Unraid Персонал

; Page Navigation
Displaying %s - %s of %s=Відображення %1$s - %2$s (з %3$s)

Updating Content=Оновлення вмісту
Language=Мова
Switch to this language=Перейти на цю мову
Country Code=Код Країни
Install Language Pack=Встановити мовний пакет
Remove Language Pack=Видалити мовний пакет
Update Language Pack=Оновити мовний пакет
Installed Version=Встановлена ​​версія
A note about translations=Примітка про переклади
Click here to view the language changelog=Натисніть тут, щоб переглянути журнал змін мови
View Missing Translations=Переглянути відсутні переклади

; Update Checks
Check For Updates=Перевірити наявність Оновлень
Check for updates already running=Перевірте, чи вже запущені оновлення
Checking for docker container updates=Перевірка оновлень контейнера Docker
Checking for plugin updates=Перевірка наявності оновлень Плагінів
Checking for language updates=Перевірка оновлень Мови
Checking %s=Перевірка %s

; dockerHub conversions
Determine configuration=Визначити конфігурацію
Would you like CA to attempt to determine any applicable paths, ports, and variables for the template This will entail performing a test installation of the container It will be automatically deleted after processing The container will not be started=Чи бажаєте ви, щоб ЦС спробував визначити будь-які застосовні шляхи, порти та змінні для шаблону? Для цього потрібно виконати пробну установку контейнера. Він буде автоматично видалений після обробки. Контейнер не запускається.
An error occurred - Could not determine configuration=Сталася помилка - Не вдалося визначити конфігурацію
; WebGui
Click Install to download and install the Community Applications plugin=Натисніть **Встановити**, щоб завантажити та інсталювати плагін **Програми спільноти**


; Note: June 25, 2022 - 220 missing translations
